#########################################################################################################################
..................######################.............##########................############......................########
.........................................................................................................................
@........................................................................................................................
#######################################################################################.....#############################