#########################################################################################################################
..................######################.............##########................############......................########
#######..............................................###############.........######.....................#################
@.................######################.................................................................................
#######################################################################################.....#############################