#########################################################################################################################
.....................................................##########................#####.............................########
#######..............................................###############.........###........................#################
@........................................................................................................................
.........................................................................................................................
..................######################.................................................................................
#######################################################################################.#.#.#############################