#########################################################################################################################
..................######################.............##########................############......................########
..................######################.....................................######.....................#################
@....................................................###############.....................................................
#######################################################################################.....#############################